Hh, Ww, Hh, Ss, Ss, Ss, Ss, Ss, Ss, Ss, Gg, Ss, Hh, Hh, Hh, Hh, Gg, Gg, Ss, Ss, Ss, Ss, Ss, Hh, Hh, Hh, Hh, Hh, Hh, Hh, Ww, Hh
Hh, Hh, Hh, Ss, Ss, Ss, Ss, Ss, Ss, Ss, Ss, Ss, Ss, Ss, Ss, Ss, Gg, Gg, Re, Ww^Bw/, Ss, Ss, Gg, Gg, Hh, Hh, Hh, Hh, Ss, Ss, Ww, Ww
Hh, Hh, Hh, Gg, Ss, Hh, Hh, Hh, Ss, Ss, Ss, Ss, Gs^Fms, Gs^Fms, Gs^Fms, Ss, Re, Re, Gg, Gg, Ss, Gg, Gg, Gg, Gg, Gg, Gg, Ss, Ss, Ss, Ww, Ww
Ss, Hh, Ss, Gg, Ss, Ss, Hh, Gg, Gg, Gg, Gg, Ss, Ss, Gs^Vl, Gs^Fms, Ss, Re, Gg, Ch, Gg, Ch, Ss, Ss, Ss, Ss, Gg, Ss, Ss, Ww, Ww, Ww, Ww
Ss, Ss, Ss, Ss, Ss^Vhs, Ss, Ss, Gg, Gg, Gg, Ss, Gs^Fms, Gs^Fms, Gs^Fms, Re, Re, Gs^Fms, Gs^Fms, Ch, Ch, Ch, Ss, Ss, Ss, Ss, Ss, Ss, Ss, Ww, Ww, Ss, Ss
Ss, Ss, Ss, Ss, Ss, Ss, Ss, Ss, Ss, Ss, Gs^Fms, Gs^Fms, Gs^Fms, Gs^Fms, Re, Gs^Fms, Gs^Fms, Gg, Gs^Fms, 1 Kh, Ss, Ss, Ss, Ss, Ss^Vhs, Gs^Fms, Ww, Ww, Ss, Ww, Ss, Ss
Ss, Ss, Ss, Ss, Ss, Ss, Ss, Ss, Ss, Ss, Ss, Ss, Ss, Gg, Re, Gs^Fms, Gs^Fms, Gs^Fms, Gs^Fms, Ss, Ss, Ss, Ss, Gs^Fms, Ww, Ww, Ww, Ss, Ww, Ww, Ss, Ss
Ss, Ss, Ss, Ss, Ss, Ss, Ss, Ss, Ss, Ss, Ss, Ss, Gg, Re, Ss, Gg, Ww^Ewl, Ww^Ewl, Ww, Ss^Vhs, Ss, Ss, Ss, Ww^Ewl, Ww, Ww, Ww, Ww, Ww, Ww, Ss, Ss
Ss, Ss, Ss, Ss, Ss, Ss, Ss, Ss, Ss, Ss, Ss, Gg, Gg, Re, Gg, Ss, Ww, Ww, Ww, Ww^Ewl, Ss, Gg, Ss, Ww, Wo, Wo, Ww, Gs^Fms, Gs^Fms, Ss, Ss, Ss
Ss, Hh, Hh, Ss, Hh, Ss, Ss, Ss, Ss, Ss, Hh, Ss, Gg, Re, Re, Ss, Ww, Wo, Ww, Ww, Gg, Gg, Gg, Ww, Wo, Ww, Gs^Fms, Gs^Fms, Gs^Fms, Ss, Ss, Ss
Hh, Hh, Hh, Hh, Ss, Ss, Ss, Ss, Ss, Hh, Hh, Ss, Ss, Gg, Re, Gs^Vl, Ww, Wo, Ww, Ww, Ww, Ww, Ww, Ww, Ww, Ww, Gs^Fms, Gs^Fms, Gs^Fms, Ss, Ss, Ss
Mm, Mm, Hh, Ss^Vhs, Ss, Ss, Ss, Ss, Ss, Ss, Ss, Ss, Ss, Ss, Re, Gg, Ww, Ww, Ww, Ww, Wo, Wo, Ww, Ww, Ww, Ss, Gs^Fms, Gs^Fms, Gs^Fms, Gs^Fms, Ss, Ss
Mm, Mm, Hh, Ss, Ss, Ss, Ss, Ss, Ss, Ss, Ss, Ss, Ss, Ch, Ww^Bw|, Ch, Ww, Ss, Ss^Vhs, Ww, Ww, Ww, Ww, Ww, Ss, Ss, Ss, Ss, Ss, Ss, Ss, Ss
Re, Hh, Hh, Ss, Ss, Ss^Vhs, Ss, Gs^Fp, Ss, Ss, Ss, Ss, Ss, Ww^Ewf, Ww^Bw|, Ww, Ss, Ss, Ss, Gg, Gg, Gs^Vc, Gg, Gg, Ss, Gg, Ss, Ss, Ss, Gs^Fms, Ss, Ss
Hh, Hh, Hh, Ss, Ss, Ss, Gs^Fp, Ss, Ss, Gg, Ss, Ss, Ww, Ww, Ww^Bw|, Ww, Ss, Ss, Ss, Gg, Gg, Gg, Gg, Gg, Ss, Gg, Ss, Ss, Ss, Ss, Ss, Ss
Re, Gg, Ss, Ss, Ss, Ss, Ss, Ss, Gg, Ww^Ewl, Ww, Ww, Ww, Ss, Re, Ss^Vhs, Ss, Ss, Ss, Ss, Gg, Gg, Gg, Gg, Ss, Gg, Ss, Ss, Ss, Gs^Fms, Ss, Gs^Fms
Gg, Re, Ss, Ss, Ss, Ss, Ss, Ss, Ww, Ww, Ww, Ww, Gg, Re, Ss, Ss, Ss, Ss, Ss, Ss, Ss, Gg, Ss, Ss, Ss, Gg, Ss, Gs^Fms, Ss, Ss, Gs^Fms, Gs^Fp
Gg, Re, Ss, Ss, Ww^Ewl, Ss, Ww, Ww, Ww, Ss, Ss, Ss, Re, Re, Gg, Ss, Ss, Ss, Ss, Ss, Ss, Ss, Ss, Ss, Ss, Ss, Ss, Gs^Fms, Gs^Fms, Gs^Fms, Gs^Fms, Gs^Fp
Gg, Re, Ss, Ss, Ww, Ww, Ww, Ww, Ss, Gs^Fp, Ss, Ss, Re, Gg, Gg, Ss, Ss, Ss, Gs^Fms, Ss, Ss, Ss, Ss, Gg, Ss, Ss, Ss, Ss, Ss, Gs^Fms, Gs^Fms, Ss
Gg, Re, Ww^Bw\, Ww, Re, Ww, Ww, Ss, Ss, Gs^Fp, Ss, Ss, Re, Gg, Gg, Ss, Ss, Gs^Fms, Gs^Fms, Ss, Ss, Ss, Hh, Hh, Hh, Ss, Ss, Ss, Ss, Ss, Ss, Ss
Gg, Gg, Ww, Re, Ww, Ww^Bw\, Re, Ss, Gs^Fp, Gs^Fp, Ss, Ss, Re, Gg, Ss, Ss, Ss, Gs^Fms, Gs^Fms, Ss^Vhs, Hh, Hh, Mm, Mm, Mm, Hh, Ss, Ss, Ss, Ss, Hh, Ss
Ww, Ww, Ww, Ww, Ss, Gs^Vl, Re, Gs^Fp, Gs^Fp, Gs^Fp, Re, Ss, Re, Ss, Re, Ss, Ss, Gg, Gg, Hh, Mm, Mm, Mm, Mm, Mm, Hh, Ss, Ss, Gg, Hh, Ss, Ss
Ww, Ww, Ww, Ww, Ss, Ss, Ss, Re, Re, Re, Gs^Fms, Re, Gg, Re, Gs^Fp, Ww^Bw\, Ww^Bw\, Gg, Cf, Mm, Cf, Mm, Mm, Mm, Mm, Mm, Hh, Ss, Ss, Gg, Ss, Ss
Ww, Ww, Ww, Ss, Ss, Ss, Ss, Gs^Fms, Gs^Fms, Gs^Fms, Gs^Fms, Gs^Fp, Gs^Vl, Gs^Fp, Gs^Fp, Ss, Ss, Ss^Bw\, Cf, Cf, Cf, Mm, Mm, Mm, Mm, Mm, Ss, Hh, Ss, Ss, Ss, Ss
Ww, Ww, Ww, Ss, Ss, Ss, Ss, Ss, Gs^Fms, Gs^Fms, Ss, Ss, Gs^Fp, Gs^Fp, Gs^Fp, Ss, Ss, Mm, Mm, 2 Kf, Mm, Mm, Mm, Mm, Mm, Hh, Ss, Ss, Ss, Ss, Ss, Ss
Ww, Ww, Ww, Ss, Ss, Ss, Gs^Fp, Ss, Ss, Ss, Ss, Ss, Gs^Fp, Gs^Fp, Ss, Ss, Ss, Ss^Vhs, Mm, Mm, Mm, Mm, Mm, Mm, Mm, Hh, Ss, Ss, Ss, Ss, Ss, Ss
Ww, Ww, Ss, Ss, Ss, Ss, Ss, Ss, Ss, Ss, Ss, Ss, Gs^Fp, Ss, Ss, Ss, Ss, Ss, Ss, Mm, Mm, Mm, Mm, Mm, Hh, Ss, Ss, Ss, Ss, Ss, Ss, Ss
Hh, Ss, Ss, Ss, Ss, Ss, Ss, Ss, Gg, Ss, Ss, Ss, Ss, Gs^Fp, Ww, Ss, Ss, Ss, Ww, Mm, Ww, Mm, Ww, Mm, Ss, Ss, Ss, Ss, Ss, Ss, Ss, Ss
