Hh, Hh, Hh, Ss, Ss, Ss, Gg, Gg, Gg, Gg, Ss, Ss, Ss, Ss, Ss, Gs^Fp, Gs^Fp, Gs^Fp, Ss, Ss, Ss, Ss, Ww^Bw/, Re, Re, Re, Re, Gg, Ss, Hh, Hh, Hh, Hh, Hh, Hh, Hh, Hh, Gg, Gg, Gg, Ss, Ss, Ss, Ss, Gg, Gg, Gg, Gg, Re, Gg, Hh, Hh, Hh, Mm, Ww, Ww, Ww, Ww, Mm, Mm, Mm, Mm, Mm, Mm, Mm, Mm, Mm, Mm, Mm, Mm, Mm, Hh
Hh, Hh, Hh, Ss, Ss, Ss, Gg, Gg, Gg, Gg, Ss, Ss, Ss, Ss, Gs^Fp, Gs^Fp, Gs^Fp, Ss, Gs^Fp, Gs^Fp, Ww^Bw/, Ww^Bw/, Ss, Ss^Vhs, Gg, Gg^Ve, Re, Gg, Gg, Hh, Hh, Hh, Hh, Hh^Vhh, Hh, Gg, Re, Gg, Gg, Gg, Ss, Ss, Ss, Ss, Re, Gg, Re, Re, Gg, Gg, Hh, Hh, Ww, Ww, Mm, Ww, Mm, Mm, Mm, Mm, Mm, Mm, Mm, Mm, Mm, Mm, Mm, Mm, Mm, Mm, Mm, Mm
Hh, Hh, Hh, Ss, Ss, Gg, Gg, Gg, Ww, Ww, Ww, Gg, Gg, Ss, Re, Ch, Ch, Ch, Re, Re, Gs^Fp, Ss, Ss, Ss, Ss, Gg, Re, Gg, Gg, Gg, Gg, Hh, Hh, Hh, Re, Re, Gg, Re, Re, Gg, Ch, Ss, Ss, Re, Gg, Re, Ww, Ww, Ww, Ss, Ww, Ww, Ww, Ww, Ww, Mm, Mm, Mm, Mm, Mm, Mm, Mm, Mm, Mm, Mm, Mm, Mm, Mm, Mm, Mm, Mm, Mm
Hh, Hh, Hh, Ss, Ss, Ss, Gg, Ww, Ww, Ss^Vhs, Ss, Ww, Gg, Ss, Ww^Bw|, Ss, Ss^Vhs, Ss, Gs^Fp, Gs^Fp, Gs^Fp, Gs^Fp, Ss, Ss, Gg, Gg, Gg, Re, Re, Gg, Gg, Gg, Re, Re, Gg, Gg, Gg, Gg^Ve, Gg, Re, Ss, Ww^Bw\, Re, Re, Ww, Gg^Ve, Ww, Ww, Ww, Ww, Ww, Ww, Ww, Mm^Vhh, Ww, Mm, Mm, Mm, Mm, Mm, Mm, Mm, Mm, Mm, Mm, Mm, Mm, Mm, Mm, Mm, Mm, Mm
Hh, Hh, Hh, Ss, Ss, Ss, Ss, Ww, Ww, Ss, Gg, Ww, Ww, Ww, Ch, Ww, Ww, Ss, Gs^Fp, Gs^Fp, Gs^Fp, Gs^Fp, Gs^Fp, Ss, Ss, Gg, Gg, Gg, Gg, Re, Re, Re, Gg, Gg, Gg, Gg, Gg, Ss, Ss, Ss, Ss, Ss, Ss, Ww, Ww, Ww, Ww, Ww, Ss, Ww, Ww, Ww, Ww, Ww, Mm^Vhh, Mm, Mm, Mm, Mm, Mm, Mm, Mm, Mm, Mm, Mm, Mm, Mm, Mm, Mm, Mm, Mm, Mm
Hh, Hh, Hh, Ww, Ww, Ww, Ss, Ww, Ss, Ss, Ch, Ch, Re, Re, Gg, Ww, Ww, Ss, Gs^Fp, Gs^Fp, Gs^Fp, Gs^Fp, Gs^Fp, Gs^Fp, Ss, Gg, Gg, Gg, Gg, Gg, Gg, Gg, Gg, Gg, Gg, Ss, Ss, Ss, Ss, Ss, Ss, Ss, Ss, Ss, Ww, Gg, Gg, Ww, Ww, Ss, Ss, Hh, Hh, Ww, Ww, Mm, Mm, Mm, Mm, Mm, Mm, Mm, Mm, Mm, Mm, Mm, Mm, Mm, Mm, Mm, Mm, Mm
Hh, Hh, Hh, Ww, Ss^Vhs, Ww, Ww, Ww, Ww, Ch, 1 Kh, Ch, Ch, Ss, Ss, Ss, Ss, Ww, Ww, Ww, Ss, Gs^Fp, Gs^Fp, Gs^Fp, Ww, Gs^Fp, Ss, Gg, Gg, Gg, Gg, Gg, Gg, Gg, Gg, Ss, Ss, Ss, Ss, Ss, Ss, Ss, Ss, Ss, Ww, Ww, Gg, Ss, Ww, Ww, Ss, Hh, Hh, Hh, Ww, Mm, Mm, Mm, Mm, Mm, Mm, Mm, Mm, Mm, Mm, Mm, Mm, Mm, Mm, Mm, Mm, Mm
Ss, Ss, Ww, Ww, Ss, Ss, Ss, Ww, Ss, Ch, Ch, Ch, Ss, Ss, Ss, Ss, Ww, Ww, Ww, Ww, Ww, Ss, Ss, Ww, Gg^Ve, Ww, Ww, Ss, Ww, Ww, Gg, Gg, Gg, Gg, Ss, Ss, Ss, Ss, Ss, Ss, Ss, Ss, Ss, Gg, Ww, Gg, Ss, Ss, Ww, Ww, Ww, Ss, Hh, Hh, Hh, Ww, Mm, Mm, Mm, Mm, Mm, Mm, Mm^Vhh, Mm, Mm, Mm, Mm, Mm, Mm, Mm, Mm, Mm
Ss, Ss, Ww, Hh, Hh, Hh, Ww, Ww, Ww, Ss, Ss, Ww^Bw|, Ss, Ss, Ss, Gg^Ve, Ww, Ww, Ss, Gg, Gg, Ww, Ss^Vhs, Ww, Gs^Fp, Gs^Fp, Ss, Ww, Ww, Ww, Gg, Gg, Ss, Ss, Ss, Ss, Ss^Vhs, Ss, Ss, Gs^Fp, Ss, Ss, Ww, Ww, Gg, Gg, Ww, Ww, Ww, Ss^Vhs, Ww, Ss, Hh, Hh, Hh, Ww, Mm, Mm, Mm, Mm, Mm, Mm, Mm, Mm, Mm, Mm, Mm, Mm, Mm, Mm, Mm, Mm
Ss, Hh, Ww, Hh, Hh, Hh, Hh, Ww, Ww, Hh, Hh, Re, Ss, Ss, Ss, Gg, Gg, Ww, Gg, Gg, Gg, Ww, Ww, Ww, Ss, Ss, Ss, Ss, Ww, Ww, Gg, Ss, Ss, Ss, Ss, Gs^Fp, Ww, Ss, Gs^Fp, Gs^Fp, Ss, Ss, Ww, Gg, Gg, Gg, Ww, Ww, Ww, Ww, Ss, Ss, Ww, Hh, Ww, Ww, Mm, Mm, Mm, Mm, Mm, Mm, Mm, Mm, Mm, Mm, Mm, Mm, Mm, Mm, Mm, Mm
Gg, Hh, Ww, Ww, Hh, Hh, Hh, Hh, Hh, Hh, Hh, Re, Hh, Hh, Hh, Gg, Gg, Ww, Gg, Gg, Gg, Gg, Gg, Ss, Ss, Ss, Ss, Ww, Ss, Ww, Ww, Ss, Ss, Ss, Ss, Ss, Ww, Ww, Ww, Ss, Ss, Ss, Ww, Gg, Ww, Ww, Ww, Ww, Ww, Ww, Ww, Ww, Ww, Ww, Hh, Ww, Ww, Ww, Mm, Mm, Mm, Mm, Mm, Mm, Mm, Mm, Mm, Mm, Mm, Mm, Mm, Hh
Gg, Hh, Ww, Hh^Vhh, Hh, Mm, Hh, Hh, Hh, Hh, Hh, Re, Re, Hh, Hh, Hh, Gg, Ww, Ww, Gg, Gg, Gg, Gg, Ss, Ss, Ss, Gs^Fp, Ww, Ww, Ww, Ss^Vhs, Ww, Ww, Ww, Ww, Ss, Ww, Ww, Ss, Ww, Ss, Ww, Ww, Ww, Ww, Gg^Ve, Ww, Ww, Ww, Ss, Ss, Ss, Ss, Ss, Hh, Ww, Ww, Ww, Ww, Mm, Mm, Mm, Mm, Mm, Mm, Mm, Mm, Mm, Mm, Mm, Hh, Hh
Hh, Hh, Ww, Hh, Hh, Mm, Mm, Hh, Hh, Hh, Hh, Hh, Re, Hh, Hh, Hh, Hh, Ww, Gg, Gg, Gg, Gg, Gg, Gg, Ww, Ww, Ww, Ww, Ww, Ww, Ss, Ww, Ww, Ss, Ss, Ww, Ww, Ww, Ww, Ww, Ww, Ww, Gg^Ve, Gg, Ww, Gg, Gg, Ss, Ww, Ww, Ss, Ss, Ss, Ss, Ww, Ww, Ww, Ww, Ww, Mm, Mm, Mm, Mm, Mm, Mm, Mm, Mm, Mm, Mm, Mm, Hh, Hh
Hh, Hh, Hh, Ww, Ww, Mm, Mm, Hh, Ww, Hh^Vhh, Ww, Hh, Hh, Re, Re, Hh, Hh, Ww, Ww, Ss, Ww, Ww, Ww, Gg, Ss, Ww, Ww, Ww, Ww, Ww, Ww, Ww, Ww, Ww, Ww, Ww, Ww, Ww, Ww, Ww, Ww, Ww, Ww, Ww, Ww, Ss, Ss, Ss, Ss, Ww, Ww, Ss, Ss, Ss, Ww, Hh^Vhh, Ww, Hh, Ww, Mm, Mm, Mm, Mm, Mm, Mm, Mm, Mm, Mm, Mm, Hh, Hh, Hh
Hh, Hh, Hh, Hh, Ww, Mm, Mm, Ww, Ww, Ww, Ww, Hh, Hh, Hh, Re, Hh, Hh, Ww, Hh, Ww, Ww, Ww, Ww, Ww, Ww, Ww, Ww, Ww, Ww, Ww, Ww, Ww, Ww, Ww, Ww, Ww, Ww, Ww, Ww, Ww, Ss, Gg, Gg, Ww, Ss, Ss, Ss, Ss, Ss, Ss, Ss, Ww, Ww, Ww, Ww, Hh, Hh, Hh, Ww, Mm, Mm, Mm, Mm, Mm, Mm, Mm, Mm, Hh, Hh, Hh, Hh, Hh
Hh, Hh, Hh, Mm, Ww, Ww, Ww, Ww, Ww, Ww, Ww, Hh, Hh, Hh, Re, Hh, Hh, Hh, Hh, Ss, Ss, Ss, Gg^Ve, Ww, Gg, Ww, Ww, Ww, Ww, Ss, Ss, Ss, Gg, Ww, Ww, Ww, Ww, Ww, Gg, Gg, Gg, Gg, Gg, Ss, Ss, Ss, Ss, Gg, Ss, Ss, Ww, Ss^Vhs, Ss, Hh, Ww, Ww, Ww, Ww, Ww, Mm, Ww, Mm, Mm, Mm, Mm^Vhh, Mm, Mm, Hh, Hh, Hh, Hh, Hh
Hh, Mm, Mm, Mm, Mm, Mm, Ww, Ww, Ww, Ww, Hh, Hh, Hh, Hh, Hh^Vhh, Re, Hh, Hh, Hh, Ss, Ww, Ww, Ww, Gg, Gg, Ss, Ww, Ww, Ss, Ss, Ss, Ss, Gg, Ww, Ww, Ss, Ww, Ww, Ww, Gg, Ss, Ww, Ww, Ss, Ss, Ss, Gg, Gg, Gg, Ww, Ww, Ww, Ww, Hh, Ww, Ww, Hh, Mm, Ww, Ww, Ww, Mm, Mm, Ww, Ww, Ww, Ww, Hh, Hh, Hh, Hh, Ss
Hh, Mm, Mm, Mm, Mm, Mm, Ww, Ww, Ww, Hh, Hh, Hh, Hh, Hh, Hh, Re, Hh, Hh, Hh, Hh, Ww, Ww, Ww, Ss, Ww, Ww, Ss^Vhs, Ww, Gs^Fp, Ss, Ss, Ss, Gg, Ww, Ss, Ss, Ss, Ss, Gg, Ww, Ww, Ww, Ww, Ww, Ss, Gg, Gg, Gg^Ve, Ww, Ww, Ss, Ss, Ww, Ww, Hh, Ww, Ww, Ww, Mm, Mm, Ww, Ww, Ww, Ww, Ww, Ww, Ww, Ww, Hh, Hh, Hh, Ss
Hh, Mm, Mm, Mm, Ww, Mm, Ww, Ww, Mm^Vhh, Ww, Ww, Hh, Mm, Hh, Hh, Re, Re, Hh, Hh, Hh, Ss, Ww, Ss, Ss, Ww, Ww, Ww, Ww, Ww, Gs^Fp, Ss, Ss, Gg, Ss, Ww, Ss, Ss, Ss, Gg, Gg, Ss^Vhs, Ww, Ss, Ss, Ss, Ss, Gg, Ww, Ww, Ww, Gg, Hh, Ww, Ww, Ww, Hh, Mm, Mm, Ww, Ww, Ww, Ww, Ww, Ww, Mm, Hh, Ww, Ww, Hh, Hh, Ss, Ss
Mm, Mm, Mm, Hh, Ww, Ww, Hh, Hh, Ww, Ww, Ww, Ww, Ww, Hh, Mm, Mm, Re, Hh, Hh, Hh, Ss, Ww, Ss, Ss, Ww, Ww, Ww, Gs^Fp, Ss, Ww, Ss, Ss, Ww, Ss, Ww, Ww, Ss, Ss, Ss, Ss, Ss, Ww, Ss, Ss, Ss, Ss, Ww, Ww, Ww, Ww, Hh, Hh, Ww, Ww, Ww, Ww, Ww, Ww, Ww, Ww, Ww, Ww, Mm, Mm, Hh, Hh, Ww, Ww, Ww, Ss, Ww, Ss
Mm, Mm, Mm, Hh, Hh^Vhh, Ww, Ww, Hh, Ww, Ww, Ww, Ww, Ww, Mm, Mm, Mm, Re, Hh, Hh, Hh, Ww, Ww, Ss, Ww, Ww, Ww, Ss, Ss, Ss, Ww, Ww, Gg, Ww, Ww, Ww, Ww, Ww, Ss, Ss, Ss, Ss, Ww, Ss, Ss, Ss, Ss, Ss, Ww, Ww, Ww, Hh, Hh, Hh, Ww, Ww, Ww, Ww, Mm^Vhh, Ww, Mm, Mm, Mm, Mm, Hh, Hh, Hh, Ww, Ss^Vhs, Ss, Ww, Ww, Ww
Mm, Mm, Hh, Hh, Hh, Hh, Hh, Ww, Ww, Ww, Ww, Ww, Mm, Mm, Mm, Mm, Hh^Vhh, Re, Hh, Ww, Ww, Ss^Vhs, Ww, Ww, Ss, Ss, Ss, Ss, Ss, Ww, Ss, Ww, Gg^Ve, Ss, Ss, Ww, Ww, Ss, Ss, Ss, Ww, Ww, Ww, Ss, Ss, Ss, Ss, Ss, Ww, Ww, Hh, Hh, Hh, Mm, Ww, Ww, Ww, Ww, Mm, Mm, Mm, Mm, Ch, Ch, Ch, Ss^Vhs, Ww, Ss, Ss, Ss, Ss, Ww
Hh, Hh, Hh, Hh, Hh, Hh, Hh, Ww, Ww, Ww, Hh, Hh, Hh, Mm, Hh, Hh, Hh, Re, Hh, Ww, Hh, Ww, Ss, Gg, Gg, Ss, Ww, Ss, Ww, Ww, Ss, Ww, Ss, Ss, Ss, Ww, Ss, Ss, Ww, Ss, Ss, Ww, Ww, Ww, Ww, Ss, Ww, Ss, Ww, Ww, Ww, Hh, Mm, Mm, Ww, Ww, Ww, Ww, Ww, Mm, Mm, Mm, Ch, 4 Kh, Ch, Ww, Ww, Ss, Ww, Ss, Ss, Ss
Hh, Hh, Hh, Hh, Hh, Hh, Hh, Ww, Ww, Ww, Hh, Hh, Hh, Mm, Hh, Hh, Hh, Re, Hh, Hh, Ss, Ss, Ss, Gg, Gg, Ss, Ww, Ww, Ww, Ww, Ww, Ww, Ss, Ss, Ww, Ww, Ww, Ww, Ww, Ss, Ss, Ss, Ww, Ww, Ww, Ww, Ss^Vhs, Ww, Ww, Ww, Ww, Hh^Vhh, Ww, Ww, Ww, Ww, Ww, Ww, Ww, Ww, Ww, Ch, Ch, Ch, Ss, Ww, Ww, Ss, Ww, Ww, Ss, Ss
Hh, Hh, Hh, Hh, Hh, Hh, Hh, Hh, Ww, Ww, Ww, Hh, Hh, Mm, Hh, Hh, Hh, Re, Re, Hh, Ss, Ss, Ss, Gg, Ww, Ww, Ss, Ss, Ww, Ww, Ss, Ss, Ww, Ww, Ww, Ss, Ss, Ss, Ww, Ww, Ww, Ww, Ww, Ww, Ww, Ww, Ss, Ss, Ss, Ww, Ww, Ww, Ww, Ww, Ww, Ww, Mm, Mm, Ww, Ww, Ww, Re, Ss, Ss, Ss, Ww, Ww, Ww, Ww, Ww, Ss, Ss
Hh, Hh, Hh, Hh, Hh, Hh, Hh, Hh, Ww, Ww, Ww, Ww, Ww, Mm, Mm, Hh, Hh, Hh, Re, Hh, Re, Ss, Ss^Vhs, Ww, Ww, Ww, Ww, Ss, Ww, Ss^Vhs, Ww, Ww, Ss, Ss^Vhs, Ww, Ss, Ss, Ss, Ss, Ww, Ww, Ss^Vhs, Ww, Ww, Ss, Ww, Ss, Ss, Ww, Ww, Ww, Ww, Ww, Ww, Mm, Ww, Ww, Mm, Ww, Ww, Hh, Re, Ss, Ss, Ss, Ww, Ww, Ww, Ww, Ww, Ss, Ss
Hh, Hh, Hh, Hh, Hh, Hh, Hh, Ww, Ww, Hh^Vhh, Ww, Ww, Ww, Mm, Mm, Hh, Hh, Hh, Hh, Re, Ss, Ww^Bw\, Ww^Bw\, Ww, Ww, Ww, Ww, Ss, Ss, Ww, Ww, Ww, Ss, Ss, Ww, Ss, Ww, Ss, Ss, Ww, Ww, Ww, Ss, Ss, Ss, Ss, Ww, Ww, Ww, Ss, Ww, Hh^Vhh, Ww, Ww, Mm, Mm, Ww, Ww, Ww^Vm, Ww, Ch, Re, Ss, Ss, Ss, Ww, Ww, Ss^Vhs, Ww, Ww, Ww, Ww
Hh, Hh, Hh, Hh, Hh, Hh, Hh, Hh, Hh, Ww, Hh, Ww, Mm^Vhh, Mm, Mm, Hh, Hh, Hh, Hh, Hh, Hh, Ss, Ss, Ww^Bw\, Ch, Ww, Ww, Ss, Ww, Ww, Ss, Ss, Ss, Ss, Ss, Ww, Ww, Ss, Ss, Ww, Ww, Ss, Ss, Ss, Ss, Ss, Ww, Ww, Ww, Ww, Ww, Ww, Ww, Hh, Ww, Ww, Ww, Ww, Ww, Ww, Ww^Bw|, Ss, Ww, Ss, Ww, Ww, Ww, Ww, Ww, Ww, Ww, Ww
Mm, Hh, Hh, Hh, Hh, Hh, Hh, Hh, Hh, Hh, Hh, Hh, Hh, Mm, Mm, Hh, Hh, Hh, Hh, Hh, Hh, Ss, Ss, Ss, Ww^Bw|, Ss, Ss, Ww, Ww, Ww, Ss, Ss, Ss, Ss, Ss, Ss, Ww, Ww, Ww, Ww, Ss, Ss, Ss, Ss, Ss, Ss, Ww, Ww, Ww, Ww, Ww, Ww, Hh, Ww, Ww, Ww, Ww, Hh, Hh, Ww, Ch, Ww, Ss, Ww, Ss^Vhs, Ww, Ww, Ww, Ww, Ww, Ss, Ww
Mm, Mm, Mm, Hh, Hh, Hh, Hh, Hh, Hh, Hh, Hh, Mm, Hh, Mm, Mm, Mm, Hh, Hh, Hh, Hh, Hh, Ss, Ss, Ss, Ch, Ss, Ch, Ww, Gg^Ve, Ww, Ww, Ss, Gg, Ss, Ww, Ww, Ss, Ss, Ss, Ww, Ss, Ss, Ss, Ss, Ww, Ww, Ww, Ww, Ww, Ww, Ss, Ss, Hh, Ww, Ww, Ww, Ww, Hh, Ww^Bw/, Ww^Bw/, Ss, Ss, Ss, Ss, Ww, Ww, Ss, Ss, Ss, Ss, Ss, Hh
Mm, Mm, Mm, Mm, Mm, Hh, Mm, Mm, Mm, Mm^Vhh, Mm, Mm, Mm, Mm, Mm, Mm, Mm, Hh, Hh, Hh, Hh, Ss, Ss, Ss, Ss, Ch, Ss, Re, Re, Gg, Ww, Ww, Gg, Ss, Ww, Ww, Ww, Ss, Ss, Ww, Ww, Ss, Ww, Ss, Ww, Ww, Ww, Ww, Ww, Ww, Ss, Ss, Ww, Ww, Ww, Ww, Re, Ww^Bw/, Ww, Ss, Ss, Ss, Ww, Ww, Ww, Ss, Ss, Ss, Ss, Ss, Hh, Hh
Mm, Mm, Mm, Mm, Mm, Mm, Mm, Mm, Mm, Mm, Mm, Mm, Mm, Mm, Mm, Mm, Hh, Hh, Hh, Hh, Hh, Ss, Ss, Ss, Ss, Ss, Ss, Ss, Gg, Re, Re, Ww, Ww, Ss, Ww, Ww, Ww, Ww, Ww, Ww, Ww, Ss, Ww, Ww, Ww, Ww, Ww, Ww, Ww, Ww, Ww, Ww, Ww, Ww, Ww, Ch, Ss, Ss, Ss^Vhs, Ww, Ww, Ss, Ww, Ww, Ww, Ss, Ss, Ss, Ss, Ss, Hh, Hh
Mm, Mm, Mm, Mm, Mm, Mm, Mm, Mm, Mm, Mm, Mm, Mm, Mm, Mm, Hh, Hh, Hh, Hh, Hh, Hh, Hh, Ss, Ss, Ss, Ss, Ss, Ss, Ss, Ss, Ss, Ss, Ch, Ss^Vhs, Ww, Ww, Ww, Ww, Ww, Ww, Ww, Ww, Ww, Ww, Ss, Ww, Ww, Ww, Ww, Ss^Vhs, Ww, Ss, Ww, Ss, Ww, Ww^Bw/, Ch, Ss, Ss, Ss, Ss, Ss, Ww, Ww, Ww, Ss, Ww, Ww, Ss, Ss, Ss, Hh, Mm
Mm, Mm, Mm, Mm, Mm, Mm, Mm, Mm, Mm, Mm, Mm, Mm, Mm, Hh, Hh, Hh, Hh, Hh, Hh, Hh, Ss^Vhs, Ss, Ss, Ss, Ss, Ss, Ss, Ss, Ss, Ss, Ww^Bw/, Ch, Ww^Bw\, Ww, Ww, Ww, Gg, Ww, Ww, Gg^Ve, Gg, Ww, Gg, Ww, Ww, Ww, Ww, Ww, Ss^Vhs, Ww, Ss, Ss, Ww^Bw/, Ww^Bw/, Ss, Ss, Ss, Ss, Ss, Ss, Ss, Gg, Gg^Ve, Ww, Ss, Ww, Ww, Ss, Ss, Ss, Hh, Mm
Mm, Mm, Mm, Mm, Mm, Mm, Mm, Mm, Mm, Mm, Mm, Mm, Hh, Hh, Hh, Hh, Hh, Hh, Hh, Hh, Ss, Ss, Ss, Ss, Ss, Ss, Ww^Bw/, Ch, Ch, Ww^Bw/, Ss, Ss, Ss, Ww^Bw\, Re, Ww, Gg, Gg, Ww, Ww, Gg, Gg, Gg, Gg, Ww, Ww, Ww, Ww, Ww, Ww, Ww^Bw/, Ww^Bw/, Ss, Ss, Ss, Ss, Ss, Ss, Ss, Ss, Gg, Ss, Gg, Ww, Ww, Ww, Ww, Ww, Ss, Hh, Hh, Mm
Mm, Mm, Mm, Mm, Mm, Mm, Mm, Mm, Mm, Mm, Mm, Mm, Mm, Hh, Hh, Hh, Hh, Gg, Ss, Ss, Ss, Ss, Ss, Ss, Ss, Ch, Ss, Ss, Ss, Ss, Ss, Ss, Ss, Ss, Hh, Re, Re, Gg, Ww, Ww, Ww, Gg, Ww, Ww, Gg, Gg^Ve, Ww, Ww, Ww^Bw/, Ww^Bw/, Ss, Ss, Ss, Ss, Ss, Ss, Ss, Ss, Ss, Ss, Ss, Ss, Ss, Ss, Ww, Ww, Ss, Ss^Vhs, Ss, Hh, Hh, Mm
Mm, Mm, Mm, Mm, Mm, Mm, Mm, Mm, Mm, Mm, Mm, Hh, Hh, Hh, Hh, Gg^Ve, Gg, Gg, Gg, Ss, Ss, Ss, Ss, Ss, Ss, Ww^Bw|, Ss, Ss, Ss, Ss, Ss, Ss, Hh, Hh, Hh, Hh, Hh, Re, Re, Ww, Ww, Ww, Ww, Ww, Gg, Ww, Ww^Bw/, Ww^Bw/, Ww, Ww, Ss, Ss, Ss, Ss, Ss, Ss, Ss, Ss, Ss, Ss, Ss, Ss, Ss, Ss, Ss, Ss, Ss, Ss, Ss, Hh, Hh, Mm
Mm, Mm, Mm, Mm, Mm, Mm, Mm, Mm, Mm, Mm, Mm, Hh, Hh, Hh, Gg, Gg, Gg, Gg, Ss, Ss, Ss, Ss, Ss, Ss, Ch, Ch, Ss, Ss, Ss, Ss, Ss, Hh, Hh, Hh, Hh, Hh, Hh, Hh, Hh, Re, Re, Gg, Ww, Gg, Re, Ww^Bw/, Ss, Ss, Ss, Ss, Ww, Ss, Ss, Ss, Ss, Ss, Ss, Ss, Ss, Ss, Ss, Ss, Ss, Ss, Ss, Ss, Ss, Ss, Ss, Hh, Hh, Hh
Mm, Mm, Mm, Mm, Mm, Mm, Mm, Mm, Mm, Mm, Hh, Hh, Hh, Ss, Gg, Ss, Ss, Ss, Ss, Ss, Ss, Ss, Ss^Vhs, Ss, Ch, Ss, Ss, Ss, Ss, Ss, Gg, Hh, Hh, Hh, Hh, Hh, Hh, Hh, Hh, Hh, Re, Gg, Ww^Bw/, Re, Ww, Ww, Ww, Ww, Ww, Ww, Ss, Ww, Ww, Ss, Ss, Ss, Ss, Ss, Ss, Ss, Ss, Ss, Ss, Ss, Ss, Ss, Ss, Ss, Ss, Ss, Hh, Hh
Mm, Mm, Mm, Mm, Mm, Mm, Mm, Mm, Mm, Hh, Hh, Hh, Ss, Ss, Ss, Ss, Ss, Ss, Ss, Ss, Ss, Ss, Re, Re, Gg, Ss, Ss, Ss, Ss, Ss, Hh, Hh, Hh, Hh, Hh, Hh, Hh, Hh, Hh, Hh, Re, Re, Ww, Ww, Ww, Ww, Ss, Ww, Ss, Ss, Ss, Ww, Ww, Ww, Ss^Vhs, Ss, Ss, Ss, Ss, Ss, Ss, Ss, Ss, Ss, Ss, Ss, Ss, Ss, Ss, Gg, Gg, Hh
Mm, Mm, Mm, Mm, Mm, Mm, Mm, Mm, Mm, Hh, Hh, Ss^Vhs, Ss, Ss, Ss, Ss, Ss, Ss, Ss, Ss, Ww^Bw/, Ww^Bw/, Gg, Gg, Gg, Ss, Ss, Ss, Ss^Vhs, Hh, Hh, Hh, Hh, Hh, Hh, Hh, Hh, Hh, Hh, Hh, Re, Ww, Ww, Ww, Ww, Ww, Ss, Gg, Gg, Ss, Ss, Ww, Ww, Ww, Ss, Ss, Ss, Ss, Ss, Ss, Ss, Ss, Ss, Gg, Gg, Ss, Gg, Gg, Gg, Gg, Gg, Ss
Mm, Mm, Mm^Vhh, Mm, Mm, Mm, Mm, Mm, Mm, Hh, Hh, Ss, Ss, Ss, Ss, Ss, Ss, Ss, Ww^Bw/, Ww^Bw/, Ss, Ss, Ss, Gg, Gg, Gg, Gg, Gg, Hh, Ww, Ww, Ww, Hh^Vhh, Hh, Hh, Hh, Hh, Hh, Hh, Hh^Vhh, Ww, Ww^Bw\, Ch, Re, Ww^Bw\, Ww, Ss, Gg, Gg, Ss, Ss, Ss, Ww, Ww, Ss, Ss, Ss, Ss, Ss, Ss, Ss, Ss, Gg, Gg, Gg, Gg, Gg, Gg, Gg, Gg, Gg, Gg
Mm, Mm, Mm, Mm, Mm, Mm, Mm, Mm, Mm, Hh, Hh, Ss, Ss, Ss, Ss, Ss, Ss, Ch, Ss, Ss, Ss, Ss, Ss, Ss, Gg, Gg, Gg, Gg, Hh, Ww, Ww, Ww, Ww, Hh, Hh, Hh, Hh, Hh, Ww, Ww, Ww, Ss, Ww, Ww, Ww, Re, Ss, Gg, Ww, Ss, Ww, Ww, Ww, Ww, Ss, Ss, Ss, Ss, Ss, Ss, Ss, Ss, Gg, Gg, Gg^Ve, Gg, Ww, Gg, Gg^Ve, Gg, Gg, Gg
Mm, Mm, Mm, Mm, Mm, Mm, Mm, Mm, Mm, Hh, Hh, Ss, Ss, Ss, Gg, Ss, Re, Re, Gs^Fp, Gs^Fp, Ss, Ss, Ss, Ss, Ss, Gg, Gg, Gg^Ve, Ww, Ww, Hh, Hh, Ww, Ww, Ww, Ww, Ww, Ww, Hh, Hh, Ww, Ww, Ww, Ww, Ww, Re, Gg^Ve, Gg, Ww, Ww, Ww, Ww, Ww, Ww, Ss, Ss, Ss, Ss, Ss, Ss, Ss, Ss, Ss, Gg, Gg, Ww, Gg, Ww, Ww, Ww, Gg, Gg
Mm, Mm, Mm, Mm, Mm, Mm, Mm, Mm, Hh, Hh, Ss, Ss, Ss, Ss, Ss, Ss, Re, Gg^Ve, Gs^Fp, Gs^Fp, Ss, Ss, Ss, Ss, Ss, Ss, Ss, Hh, Ww, Ww, Ww, Mm, Ww, Ww, Ww, Ww, Hh, Hh, Hh, Hh, Hh, Ww, Hh, Ss, Ss, Re, Ww, Gg, Ww, Ww, Ww, Ww, Gg^Ve, Gg, Ww, Ww, Ww, Ss, Ww, Ww, Ww, Ss, Ww, Ww, Ww, Ww, Ww, Ww, Ww, Gg, Ss, Ss
Mm, Mm, Mm, Mm, Mm, Mm, Mm, Mm, Hh, Hh, Ss^Vhs, Ss, Ss, Ss, Ss, Ss, Re, Gs^Fp, Gs^Fp, Ss, Ss, Ww, Ww, Ss, Ss, Ss, Ss, Hh, Hh, Ww, Ww, Ww, Ww, Ww, Ww, Ww, Hh, Hh, Hh, Hh, Hh, Hh, Hh, Hh, Ss, Re, Ww, Ww, Ww, Ww, Ww, Ww, Ww, Ww, Ww, Ss, Ww, Ss, Ss, Ww, Ww, Ww, Ww, Ss, Ww, Ww, Ss, Ww, Ss, Ss, Ss, Ss
Mm, Mm, Mm, Mm, Mm, Mm, Mm, Mm, Mm, Hh, Hh, Ss, Ss, Ss, Re, Ww^Bw/, Gs^Fp, Gs^Fp, Gs^Fp, Ss, Ss, Ww, Ww, Ww, Ww, Ss, Hh, Hh, Hh, Hh, Mm, Ww, Mm, Ww, Ww, Hh, Ww, Hh, Hh, Hh, Hh^Vhh, Hh, Hh, Hh, Hh, Re, Re, Ww, Ss, Ww, Ww, Ss, Ww, Ww, Ww, Ww, Ww, Ss, Ss, Ww, Ww, Ww, Ss, Hh, Hh, Ww, Ww, Ww, Ww, Ww, Ww, Ss
Mm, Mm, Mm, Mm, Mm, Mm, Mm, Mm, Mm, Hh, Hh, Ch, Ch, Ch, Re, Ss, Ww, Ww, Ww, Ss, Ss, Ss^Vhs, Ww, Ss, Ww, Ss, Ww, Hh, Ww, Ww, Ww, Mm, Mm, Hh, Hh^Vhh, Ww, Ww, Hh, Hh, Hh, Hh, Hh, Hh, Hh, Hh, Ss, Ww^Bw|, Ww, Ww, Ww, Ss^Vhs, Ww, Ww, Ww, Gg, Ss^Vhs, Ww, Ww, Ss, Ss, Ss^Vhs, Ww, Ss, Hh, Hh, Ww, Ww, Ww, Ss, Ss, Ww, Ww
Mm, Mm, Mm, Mm, Mm, Mm, Mm, Mm, Mm, Mm, Hh, Ch, 2 Kh, Ch, Ss, Gs^Fp, Ww, Ww, Ww, Ww, Ww, Ss, Ss, Ww, Ww, Ww, Hh, Ww, Ww, Ww, Mm, Mm, Ww, Mm, Ww, Ww, Ww, Hh, Mm, Mm, Mm, Mm, Mm, Hh, Hh, Hh, Ww^Bw|, Ww, Gs^Fp, Ww, Ww, Ww, Ww, Gg, Gg, Ss, Ww, Ww, Ww, Ww, Ww, Ww, Hh, Hh, Hh, Ww, Ww, Ww, Hh, Ss, Hh, Ww
Mm, Mm, Mm, Mm, Mm, Ww, Ww, Mm, Ww, Mm, Ch, Ch, Ch, Ss, Ss, Ss, Ww, Ww, Ww, Ss, Ww, Ww, Ss, Ww, Ss, Ww, Ww, Ww, Ww, Ww, Ww, Ww, Ww, Ww, Mm, Mm, Mm, Mm, Mm, Mm, Mm, Mm, Mm, Mm, Hh, Hh^Vhh, Ww^Bw|, Ss, Gs^Fp, Ww, Ww, Ww, Ww, Ww, Ss, Ss, Ww, Ww, Ww, Ww, Ww, Ww, Ww, Hh, Ww, Hh, Ww, Ss, Ww, Ww, Ww, Hh
Mm, Mm, Mm, Mm, Ww, Ww, Mm^Vhh, Ww, Ww, Mm, Hh, Hh, Ww, Ss, Ss, Ss, Ss, Ss, Ww, Ww, Ww, Ww, Ww, Ww, Ww, Ww, Hh^Vhh, Ww, Ww, Ww, Mm, Ww, Mm, Mm, Mm, Mm, Mm, Mm, Mm, Mm, Mm, Mm, Mm, Mm, Mm, Hh, Re, Hh, Ss, Ss, Gs^Fp, Ww, Ww, Ww, Ww, Ww, Ww, Ww, Ww, Ww, Ww, Ss, Hh, Ww, Ww, Ww, Ww, Ww, Ww, Ww, Ww, Ww
Mm, Mm, Mm, Mm, Ww, Mm, Mm, Ww, Ww, Ww, Ww, Hh, Ww, Ww, Ss, Ss, Ss, Ww, Ss, Ww, Ww, Ww, Ss, Ss, Hh, Ww, Hh, Ww, Ww, Ww, Mm, Mm, Mm, Mm, Mm, Mm, Mm, Mm, Mm, Mm, Mm, Mm, Mm, Mm, Mm, Hh, Re, Hh, Hh, Hh, Ww, Ww, Ww, Ww, Ss, Ww, Ww, Ww, Ww, Ww, Ww, Ww, Ww, Hh, Hh, Ww, Ww, Ww, Ww, Ww, Ww, Ww
Mm, Mm, Mm, Mm, Ww, Mm, Mm, Ww, Mm^Vhh, Ww, Ww, Ww, Ww, Ww, Ss, Ss, Ss, Ww, Ww, Gg, Ww, Ww, Gg, Hh, Hh, Hh, Hh, Ww, Hh, Mm, Mm, Mm, Mm, Mm, Mm, Mm, Mm^Vhh, Mm, Mm, Mm, Mm, Mm, Mm, Mm, Mm, Hh, Re, Hh, Hh, Hh, Ww, Ww, Ww, Ss, Ss, Ss, Ww, Ss^Vhs, Ss, Ww, Ww, Ss, Ww, Hh, Ww, Ww, Hh, Ww, Ww, Ww, Ww, Ww
Mm, Mm, Ww, Ww, Ww, Mm, Mm, Ww, Ww, Mm, Mm, Ww, Ww, Ww, Hh, Ss, Ss, Gg^Ve, Ww, Ww, Ww, Ww, Hh, Hh, Hh, Hh, Hh, Ww, Ww, Ww, Mm, Mm, Mm, Mm, Mm, Mm, Mm, Mm, Mm, Mm, Mm, Mm, Mm, Mm, Mm, Mm, Re, Hh, Hh, Hh, Ww, Ww, Ww, Ss, Ss, Ss, Ww, Ss, Ss, Ss, Ss, Ww, Ww, Ww, Ww, Ww, Ww, Ww, Hh, Ww, Ww, Ww
Mm, Ww, Mm, Ww, Ww, Mm, Mm, Ww, Ww, Mm, Ww, Ww, Mm, Ww, Ww, Ww, Ww, Ss, Gg, Gg, Ww, Ww, Hh, Hh, Hh, Hh, Hh, Ww, Ww, Ww, Mm, Mm, Mm, Mm, Mm, Mm, Mm, Mm, Mm, Mm, Mm, Mm, Mm, Mm, Mm, Mm, Hh, Re, Hh, Hh, Ww, Ww, Hh, Ss, Hh, Ss, Ww, Hh, Hh, Hh, Hh, Ww, Ww, Ww, Hh^Vhh, Ww, Ww, Ww, Hh, Hh, Hh, Ww
Ww, Ww, Ww, Ww, Ww, Ww, Ww, Ww, Ww, Mm, Ww, Ww, Ww, Ww, Ww, Ww, Hh, Hh, Ww, Ww, Hh^Vhh, Hh, Hh, Hh, Hh, Hh, Hh, Ww, Ww, Ww, Mm, Mm, Mm, Mm, Mm, Mm, Mm, Mm, Mm, Mm, Mm, Mm, Mm, Mm, Mm, Mm, Mm, Re, Mm, Hh, Ww, Hh, Ww, Ww, Ww, Hh, Ww, Ww, Ww, Hh, Ww, Ww, Ww, Hh, Ww, Ww, Ww, Ss^Vhs, Ss, Ss, Ss, Ss
Mm, Ww, Ww^Vm, Ww, Mm, Ww, Ww, Ww, Ww, Ww, Mm, Ww, Ww, Ww, Ww, Ww, Ww, Hh, Ww, Hh, Hh, Hh, Hh, Hh, Hh, Mm, Hh, Ww, Hh^Vhh, Ww, Ww, Ww, Ww^Vm, Ww, Hh, Hh, Mm, Mm, Mm, Mm, Mm, Mm, Mm, Mm, Mm, Mm, Mm, Re, Mm, Mm, Ww, Ww, Ww, Ww, Hh^Vhh, Ww, Ww, Ww, Ww, Ww, Ww, Ww, Hh, Hh, Ww, Ww, Ww, Ss, Ss, Ss, Ss, Ss
Ww, Ww, Ww, Ww, Mm, Mm, Ww, Ww, Ww, Ww, Ww, Ww, Ww, Ww, Ww, Mm^Vhh, Ww, Ww, Ww, Hh, Hh, Mm, Mm, Mm, Mm, Mm, Hh, Hh, Hh, Hh, Ww, Ww, Ww, Ww, Hh, Hh, Mm, Mm, Mm, Mm, Mm, Mm, Mm, Mm, Mm, Mm, Mm^Vhh, Re, Mm, Mm, Mm, Hh, Hh, Hh, Hh, Hh, Ww, Ww, Ww, Hh, Hh, Ww, Hh, Hh, Hh, Ss, Ss, Ss, Ss, Ss, Ss, Ss
Ww, Ww, Ww, Ww, Ww, Mm, Mm, Ww, Ww, Ww, Ww, Mm, Ww, Mm, Mm, Ww, Mm, Ww, Ww, Mm, Mm, Mm, Mm, Mm, Mm, Mm, Hh, Hh, Hh, Ww, Ww, Ww, Ww, Hh, Hh, Hh, Mm, Mm, Mm, Mm, Mm, Mm, Mm, Mm, Mm, Mm, Mm, Re, Re, Mm, Mm, Mm, Hh, Hh, Hh, Hh, Ww, Ww, Ww, Ww, Hh, Ww, Hh, Hh, Hh, Hh, Ss, Gg, Ss, Ss, Ww^Bw/, Ss
Ww, Ww, Ww, Ww, Ww, Mm, Mm, Ww, Ww, Ww, Ww, Ww, Ww, Mm, Mm, Mm, Mm, Mm, Mm, Mm, Mm, Mm, Mm, Mm, Mm, Mm, Hh, Hh, Hh, Ww, Ww, Ww, Ww, Hh, Hh, Hh, Mm, Mm, Mm, Mm, Mm, Mm, Mm, Mm, Mm, Mm, Mm, Mm, Mm, Re, Re, Mm, Mm, Mm, Mm, Mm, Ww, Ww, Ww, Ww, Ww, Ww, Hh, Hh, Hh, Hh, Re, Re, Re, Re, Gg, Ww
Ww, Ww, Ww, Mm, Ww, Ww, Mm^Vhh, Ww, Ww, Ww, Ww, Ww, Ww, Ww, Ww, Mm, Mm, Mm, Mm, Mm, Mm, Mm, Mm, Mm, Mm, Mm, Hh, Hh, Hh, Hh, Ww, Ww, Ww, Hh, Hh, Hh, Hh, Mm^Vhh, Mm, Mm, Mm, Mm, Mm, Mm, Mm, Mm, Mm, Mm, Mm, Mm, Re, Mm, Mm, Mm, Mm, Ww, Ww^Vm, Ww, Ww, Ww, Ww, Mm, Ww, Hh, Ww^Bw/, Re, Hh, Ss, Ss, Ss, Ww, Ww
Mm, Mm, Mm, Mm, Mm, Ww, Ww, Ww, Ww, Ww, Ww, Ww, Ww, Ww, Mm, Mm, Mm, Mm, Mm, Mm, Mm^Vhh, Mm, Mm, Mm, Mm, Mm, Mm, Hh, Hh, Hh, Ss, Ww, Ww, Ww, Hh, Hh, Mm, Mm, Mm, Mm, Mm, Mm, Mm, Mm, Mm, Mm, Mm, Mm, Mm, Mm, Re, Mm, Ww, Ww, Mm, Ww, Ww, Ww, Ww, Ww, Mm, Mm, Ww^Bw/, Ww^Bw/, Ww, Ww, Hh, Hh, Hh, Ss, Ww, Ww
Ww, Mm, Mm, Mm, Mm, Mm, Mm, Ww, Ww, Mm, Ww, Ww, Ww, Mm, Mm, Mm, Mm, Mm, Mm, Mm, Mm, Mm, Mm, Mm, Mm, Mm, Mm, Hh, Hh, Hh, Hh, Ww, Ww, Hh^Vhh, Hh, Hh, Hh, Mm, Mm, Mm, Mm, Mm, Mm, Mm, Ww, Mm, Ww^Bw/, Ch, Ch, Re, Mm, Ch, Ww, Ww, Ww, Ww, Ww, Ww, Ww, Ww, Ww^Bw/, Re, Ww, Ww, Mm, Hh, Hh, Hh, Hh, Ww, Ww, Ss
Ww, Ww, Mm, Mm, Mm, Mm, Mm, Ww, Ww, Ww, Ww, Ww, Ww, Mm, Mm, Mm, Mm, Mm, Mm, Mm, Mm, Mm, Mm, Mm, Mm, Mm, Mm, Hh, Hh^Vhh, Hh, Ss, Ww, Ww, Ww, Ww, Hh, Hh, Mm, Mm, Mm, Mm, Mm, Mm, Ww, Ch, Ww^Bw/, Mm, Ww, Ww, Mm, Mm, Ch, Re, Mm^Vhh, Ww, Ww, Ww, Ww, Ww^Bw/, Ww^Bw/, Ww, Ww, Ww, Ww, Mm, Hh, Ww, Ww, Ww, Ww, Ww, Ww
Ww, Ww, Ww, Mm, Mm, Mm, Ww, Ww, Ww, Ww, Ww, Mm, Mm^Vhh, Ww, Ww, Mm, Mm, Mm, Mm, Mm, Mm, Mm, Mm, Mm, Mm, Mm, Mm, Mm, Hh, Hh, Hh, Hh, Ss, Hh, Ww, Ww, Ww, Hh, Mm, Mm, Mm, Mm, Ww, Ww, Re, Mm, Mm, Ww, Mm, Mm, Mm, Ww, Mm, Re, Ww, Ww, Re, Re, Hh, Ww, Ww, Ww, Ww, Mm^Vhh, Ww, Hh, Ww, Ww, Ww, Ww, Ww, Ww
Ww, Ww, Ww, Ww, Ww^Vm, Ww, Ww, Ww, Ww, Ww, Ww, Ww, Ww, Ww, Mm, Mm, Mm, Mm, Mm, Mm, Mm, Mm, Mm, Mm, Mm, Mm, Mm, Mm, Hh, Hh, Ww, Ww, Ww, Hh, Ww, Ww, Ww, Ww, Mm, Mm, Mm, Mm, Ww, Ww, Ch, Mm, Ww, Ww, Ww, Mm, Ww, Ww, Hh, Re, Ch, Ch, Ch, Hh, Hh, Ww, Ww, Ww, Ww, Ww, Ww, Ww, Ww, Ww, Ww, Hh, Ww, Ww
Ww, Ww, Mm, Ww, Ww, Ww, Ww, Mm, Mm, Ww, Mm^Vhh, Ww, Mm, Ww, Mm, Mm, Mm, Mm, Mm, Mm, Mm, Mm, Mm, Mm, Mm, Mm, Mm, Mm, Mm, Hh, Ww, Ww, Hh, Ww, Hh, Ww, Ww, Hh, Mm, Mm, Mm, Mm, Ww, Ch, Ww, Ww, Ww, Ww, Ww, Ww, Mm, Ww, Hh, Hh, Ch, 3 Kh, Ch, Hh, Ww, Ww, Ww, Ww, Hh, Ww, Ww, Mm, Ww, Ww, Hh, Hh, Ww, Ww
Ww, Ww, Mm, Mm, Ww, Ww, Ww, Mm, Ww, Ww, Ww, Mm, Mm, Mm, Mm, Mm, Mm, Mm, Mm, Mm^Vhh, Mm, Mm, Mm, Mm, Mm, Mm, Mm, Mm, Mm, Hh, Ww, Ww, Hh^Vhh, Hh, Hh, Hh, Hh, Mm, Mm, Mm, Ww, Ww, Ww, Ww^Bw|, Ww, Mm^Vhh, Mm, Ww, Ww, Ww, Hh, Hh, Hh, Ch, Ch, Ch, Ss, Ww, Hh, Hh, Hh, Ww, Ww, Ww, Hh, Hh, Ww, Ww, Hh, Hh, Hh, Hh
Ww, Ww, Ww, Ww, Ww, Ww, Ww, Ww, Ww, Ww, Ww, Mm, Mm, Mm, Mm, Mm, Mm, Mm, Mm, Mm, Mm, Mm, Mm, Mm, Mm, Mm, Mm, Mm, Mm, Mm, Hh, Ww, Hh, Hh, Hh, Hh, Hh, Ww, Ww^Vm, Ww, Ww, Ww, Ww^Bw/, Ch, Mm, Ww, Ww, Ww, Ww, Ww, Ww, Hh, Hh, Ss, Ss, Ss, Ww, Ww, Ss, Hh, Hh, Ww, Ww, Hh, Hh, Hh, Hh, Hh, Hh, Hh, Mm, Hh
Ww, Ww, Ww, Ww, Ww, Ww, Ww, Ww, Ww, Ww, Mm, Ww, Mm, Mm, Mm, Mm, Mm, Mm, Mm, Mm, Mm, Mm, Mm, Mm, Mm, Mm, Mm, Mm, Mm, Mm, Mm, Hh, Hh, Hh, Hh, Hh, Hh, Ww, Ww, Ww, Ch, Ww^Bw/, Ww, Ww, Ww, Ww, Mm, Ww, Mm, Ww, Ww, Ww, Ww, Ss, Ss, Ss, Ww, Ss^Vhs, Ss, Ss, Ss, Ww, Ss, Ss, Hh, Hh, Hh, Hh, Hh, Hh, Ww, Mm
Ww, Ww, Ww, Ww, Ww, Ww, Mm, Ww, Ww, Ww, Ww, Ww, Ww, Ww, Mm, Mm, Mm, Mm, Mm, Mm, Mm, Mm, Mm, Mm, Mm, Mm, Mm, Mm, Mm, Mm, Hh, Hh, Hh, Hh, Hh, Hh, Ww, Ww, Ww, Mm, Re, Mm, Mm, Ww, Ww, Mm, Ww, Ww, Mm, Hh, Ww, Ww, Ss, Ss, Ss, Ss, Ww, Ww, Ss, Ss, Ss, Ww, Ss^Vhs, Ss, Ss, Hh, Hh, Hh, Hh, Hh, Ww, Ww
Ww, Ww, Ww, Ww, Mm, Hh, Ww, Ww, Ww, Ww, Ww, Mm, Mm, Ww, Ww, Mm, Ww, Ww, Ww, Ww, Mm, Mm, Mm, Mm, Mm, Mm, Mm, Mm, Mm, Mm, Hh, Hh, Hh, Hh, Hh, Hh, Ww, Ww, Mm, Mm, Re, Mm, Mm, Mm, Mm, Ww, Mm, Ww, Ww, Ww, Hh, Hh, Hh, Ss, Ss, Ww, Ww, Ss, Ss, Ss, Ss, Ww, Ww, Ww, Ww, Hh, Hh, Hh, Ww, Ww, Ww, Ww
