Xoc, Xoc, Xoc, Xoc, Xoc, Xoc, Xoc, Xoc, Xoc, Xoc, Xoc, Xoc, Xoc, Xoc, Xoc, Xoc, Xoc
Xoc, Xoc, Xoc, Xoc, Xoc, Xoc, Xoc, Xoc, 1 Kf, Xoc, Xoc, Xoc, Xoc, Xoc, Xoc, Xoc, Xoc
Xoc, Xoc, Xoc, Xoc, Xoc, Xoc, Ur, Cf, Cf, Cf, Ur, Xoc, Xoc, Xoc, Xoc, Xoc, Xoc
Xoc, Xoc, Xoc, Xoc, Xoc, Xoc, Ur, Ur, Ur, Ur, Ur, Xoc, Xoc, Xoc, Xoc, Xoc, Xoc
Xoc, Xoc, Cf, Ur, Ur, Xoc, Ur, Ur, Ur, Ur, Ur, Xoc, Ur, Ur, Cf, Xoc, Xoc
Xoc, 6 Kf, Cf, Ur, Ur, Ur, Xoc, Ur, Ur, Ur, Xoc, Ur, Ur, Ur, Cf, 2 Kf, Xoc
Xoc, Cf, Ur, Ur, Ur, Ur, Xoc, Xoc, Ur, Xoc, Xoc, Ur, Ur, Ur, Ur, Cf, Xoc
Xoc, Ur, Ur, Ur, Ur, Ur, Ur, Ur, Ur, Ur, Ur, Ur, Ur, Ur, Ur, Ur, Xoc
Xoc, Xoc, Xoc, Ur, Xoc, Xoc, Ur, Ur, Ur, Ur, Ur, Xoc, Xoc, Ur, Xoc, Xoc, Xoc
Xoc, Xoc, Ur, Ur, Ur, Xoc, Ur, Ur, Ur, Ur, Ur, Xoc, Ur, Ur, Ur, Xoc, Xoc
Xoc, Ur, Ur, Ur, Ur, Ur, Xoc, Ur, Ur, Ur, Xoc, Ur, Ur, Ur, Ur, Ur, Xoc
Xoc, Cf, Cf, Ur, Ur, Ur, Xoc, Xoc, Ur, Xoc, Xoc, Ur, Ur, Ur, Cf, Cf, Xoc
Xoc, 5 Kf, Cf, Ur, Ur, Ur, Ur, Ur, Ur, Ur, Ur, Ur, Ur, Ur, Cf, 3 Kf, Xoc
Xoc, Xoc, Xoc, Ur, Xoc, Xoc, Ur, Ur, Ur, Ur, Ur, Xoc, Xoc, Ur, Xoc, Xoc, Xoc
Xoc, Xoc, Xoc, Xoc, Xoc, Xoc, Ur, Ur, Cf, Ur, Ur, Xoc, Xoc, Xoc, Xoc, Xoc, Xoc
Xoc, Xoc, Xoc, Xoc, Xoc, Xoc, Xoc, Cf, 4 Kf, Cf, Xoc, Xoc, Xoc, Xoc, Xoc, Xoc, Xoc
Xoc, Xoc, Xoc, Xoc, Xoc, Xoc, Xoc, Xoc, Xoc, Xoc, Xoc, Xoc, Xoc, Xoc, Xoc, Xoc, Xoc
Xoc, Xoc, Xoc, Xoc, Xoc, Xoc, Xoc, Xoc, Xoc, Xoc, Xoc, Xoc, Xoc, Xoc, Xoc, Xoc, Xoc
